Type,Country,June,July,August,Total,Profit
Vanilla,BE,610,190,670,1470,1
Chocolate,BE,170,690,520,1380,1
Speculos,BE,560,320,140,1020,0
Chocolate,DE,610,640,320,1570,1
Lemon,BE,300,270,290,860,0
Vanilla,FR,430,350,300,1080,1
Vanilla,DE,250,650,630,1530,1
Chocolate,NL,210,280,270,760,0
Vanilla,ES,710,590,770,2070,1
Caramel,FR,370,490,420,1280,
Vanilla,IT,560,330,160,1050,
Speculos,IT,610,640,630,1880,
